Position: {0,0}
Map:
{
1121212122121212
2121212212212121
1212122122122122
1212121221221212
1221212121222122
2122121212121221
2122122121212121
1212212121221212
2121212121211121
2122212112121212
1221212121222121
1212122121222112
2121212211221212
2121222122121112
1212122221112212
1221212212121212
}
EntitiesOnMap:
{
()
}